@@@@@@@@@@@@@@@@@@@@@@@@@@@@@@@@@@@@@@@@@@@@@@@@@@@@@@@@@@@@@@@@@@@@@@@@@@@@@@@@@@@@@@@@@@@@@@@@@@@@@@@@@@@@@@@@@@@@@@@@@@@@@@@@@@@@@@@@@@@@@@@@@@@@@@@@@@@@@@@@@@@@@@@@@@@@@@@@@@@@@@@@@@@@@@@@@@@@@@@@@@@@@@@@@@@@@@@@@@@@@@@@
@                                                                                                                                                                                                                              @
@                                                                                                                                                                                                                              @
@                                                                                                                                                                                                                              @
@                                                                                                                                                                                                                              @
@                                                                                                                                                                                                                              @
@                                                                                                                                                                                                                              @
@                                                                                                                                                                                                                              @
@                                                                                                                                                                                                                              @
@                                                                                                                                                                                                                              @
@                                                                                                                                                                                                                              @
@                                                                                                                                                                                                                              @
@                                                                                                                                                                                                                              @
@                                                                                                                                                                                                                              @
@                                                                                                                                                                                                                              @
@                                                                                                                                                                                                                              @
@                                                                                                                                                                                                                              @
@                                                                                                                                                                                                                              @
@                                                                                                                                                                                                                              @
@                                                                                                                                                                                                                              @
@                                                                                                                                                                                                                              @
@                                                                                                                                                                                                                              @
@                                                                                                                                                                                                                              @
@                                                                                                                                                                                                                              @
@                                                                                                                                                                                                                              @
@                                                                                                                                                                                                                              @
@                                                                                                                                                                                                                              @
@                                                                                                                                                                                                                              @
@                                                                                                                                                                                                                              @
@                                                                                                                                                                                                                              @
@                                                                                                                                                                                                                              @
@                                                                                                                                                                                                                              @
@                                                                                                                                                                                                                              @
@                                                                                                                                                                                                                              @
@                                                                                                                                                                                                                              @
@                             @@@@@@@@@@@@@@@@@@@@@@@@@@@@@@@@@@@@@@@@@@@@@@@@@@@@@@@@@@@@@@@@@@@@@@@@@@@@@@@@@@@@@@@@@@@@@@@@@@@@@@@@@@@@@@@@@@@@@@@@@@@@@@@@@@@@@@@@@@@@@@@@@@@@@@@@@@@@@@@@@@@@                             @
@                             @@@@@@@@@@@@@@@@@@@@@@@@@@@@@@@@@@@@@@@@@@@@@@@@@@@@@@@@@@@@@@@@@@@@@@@@@@@@@@@@@@@@@@@@@@@@@@@@@@@@@@@@@@@@@@@@@@@@@@@@@@@@@@@@@@@@@@@@@@@@@@@@@@@@@@@@@@@@@@@@@@@@                             @
@                             @@@@@@@@@@@@@@@@@@@@@@@@@@@@@@@@@@@@@@@@@@@@@@@@@@@@@@@@@@@@@@@@@@@@@@@@@@@@@@@@@@@@@@@@@@@@@@@@@@@@@@@@@@@@@@@@@@@@@@@@@@@@@@@@@@@@@@@@@@@@@@@@@@@@@@@@@@@@@@@@@@@@                             @
@                             @@@                                                                                                                                                              @@@                             @
@                             @@@                                                                                                                                                              @@@                             @
@                             @@@                                                                                                                                                              @@@                             @
@                             @@@                                                                                                                                                              @@@                             @
@                             @@@                                                                                                                                                              @@@                             @
@                             @@@                                                                                                                                                              @@@                             @
@                             @@@                                                                                                                                                              @@@                             @
@                             @@@                                                                                                                                                              @@@                             @
@                             @@@                                                                                                                                                              @@@                             @
@                             @@@                                                                                                                                                              @@@                             @
@                             @@@                                                                                                                                                              @@@                             @
@                             @@@                                                                                                                                                              @@@                             @
@                             @@@                                                                                                                                                              @@@                             @
@                             @@@                        *            *            *             *                        *            *            *            *            *                @@@                             @
@                             @@@                                                                                                                                                              @@@                             @
@                             @@@                                                                                                                                                              @@@                             @
@                             @@@                                                                                                                                                              @@@                             @
@                             @@@                                                                                                                                                              @@@                             @
@                             @@@                                                                              *                                                                        *      @@@                             @
@                             @@@                                                                                                                                                              @@@                             @
@                             @@@                                                                                                                                                              @@@                             @
@ You can jump 4 times at a time.  &                                                                                                                                                           @@@                             @
@ Challenge yourself!!!       @@@@@@@@@@@                                                                   @@@@@@@                                                                 @@@@@@@@@@@@@@                             @
@                             @@@       @                                                                                                                                           @I'm not a liar.                           @
@                             @@@@@@@@@@@                                                                                                                                           @@@@@@@@@@@@@@                             @
@                             @@@                                                                                                                                                              @@@                             @
@                             @@@                                                                                                                                                              @@@                             @
@                             @@@                                                                                                                                                              @@@                             @
@                             @@@                                                                                                                                                              @@@                             @
@                             @@@######################################       #######################################################################       ###################################@@@                             @
@                             @@@@@@@@@@@@@@@@@@@@@@@@@@@@@@@@@@@@@@@@@@@@@@@@@@@@@@@@@@@@@@@@@@@@@@@@@@@@@@@@@@@@@@@@@@@@@@@@@@@@@@@@@@@@@@@@@@@@@@@@@@@@@@@@@@@@@@@@@@@@@@@@@@@@@@@@@@@@@@@@@@@@                             @
@                             @@@@@@@@@@@@@@@@@@@@@@@@@@@@@@@@@@@@@@@@@@@@@@@@@@@@@@@@@@@@@@You need to remember the title of this game.@@@@@@@@@@@@@@@@@@@@@@@@@@@@@@@@@@@@@@@@@@@@@@@@@@@@@@@@@@                             @
@                             @@@@@@@@@@@@@@@@@@@@@@@@@@@@@@@@@@@@@@@@@@@@@@@@@@@@@@@@@@@@@@@@@@@@@@@@@@@@@@@@@@@@@@@@@@@@@@@@@@@@@@@@@@@@@@@@@@@@@@@@@@@@@@@@@@@@@@@@@@@@@@@@@@@@@@@@@@@@@@@@@@@@                             @
@                                                                                                                                                                                                                              @
@                                                                                                                                                                                                                              @
@                                                                                                                                                                                                                              @
@                                                                                                                                                                                                                              @
@                                                                                                                                                                                                                              @
@                                                                                                                                                                                                                              @
@                                                                                                                                                                                                                              @
@                                                                                                                                                                                                                              @
@                                                                                                                                                                                                                              @
@                                                                                                                                                                                                                              @
@                                                                                                                                                                                                                              @
@                                                                                                                                                                                                                              @
@                                                                                                                                                                                                                              @
@                                                                                                                                                                                                                              @
@                                                                                                                                                                                                                              @
@                                                                                                                                                                                                                              @
@                                                                                                                                                                                                                              @
@                                                                                                                                                                                                                              @
@                                                                                                                                                                                                                              @
@                                                                                                                                                                                                                              @
@                                                                                                                                                                                                                              @
@                                                                                                                                                                                                                              @
@                                                                                                                                                                                                                              @
@                                                                                                                                                                                                                              @
@                                                                                                                                                                                                                              @
@                                                                                                                                                                                                                              @
@                                                                                                                                                                                                                              @
@                                                                                                                                                                                                                              @
@@@@@@@@@@@@@@@@@@@@@@@@@@@@@@@@@@@@@@@@@@@@@@@@@@@@@@@@@@@@@@@@@@@@@@@@@@@@@@@@@@@@@@@@@@@@@@@@@@@@@@@@@@@@@@@@@@@@@@@@@@@@@@@@@@@@@@@@@@@@@@@@@@@@@@@@@@@@@@@@@@@@@@@@@@@@@@@@@@@@@@@@@@@@@@@@@@@@@@@@@@@@@@@@@@@@@@@@@@@@@@@@