@@@@@@@@@@@@@@@@@@@@@@@@@@@@@@@@@@@@@@@@@@@@@@@@@@@@@@@@@@@@@@@@@@@@@@@@@@@@@@@@@@@@@@@@@@@@@@@@@@@@@@@@@@@@@@@@@@@@@@@@@@@@@@@@@@@@@@@@@@@@@@@@@@@@@@@@@@@@@@@@@@@@@@@@@@@@@@@@@@@@@@@@@@@@@@@@@@@@@@@@@@@@@@@@@@@@@@@@@@@@@@@@
@                                                                                                              @@#                                                                                                             @
@                                                                                                              @@                                                                                                              @
@                                                                                                              @@                                                  #                                    *                      @
@                                                                                                              @@                                                                                                              @
@                                                                                                             #@@                                                                                                              @
@                                                                                                              @@                         #                                                                                    @
@        @@@@@@@@@@@@@@@@@@@@@@@@@@@@@@@@@@@@@@@@@@                                                            @@                                       *                    @@@@@@@@@@@@@@@@@@@@@@@@@@@@@@@@@@@@@@@@@@        @
@        @#########################################                                                            @@                                                            #########################################@        @
@        @#@@@@@@@@@@@@@@@@@@@@@@@@@@@@@@@@@@@@@@@@                                                            @@#                *                                          @@@@@@@@@@@@@@@@@@@@@@@@@@@@@@@@@@@@@@@@#@        @
@        @#@                                                                                                   @@                        #                                                                          @#@        @
@        @#@                                                                                                   @@                                                                                                   @#@        @
@        @#@                                                                                                   @@                                               #                                                   @#@        @
@        @#@                                                                                                   @@                                                                                                   @#@        @
@        @#@                                                                                                  #@@       #                                                               *         *         *       @#@        @
@        @#@                                                                                                   @@                                                                                                   @#@        @
@        @#@                                                                                                   @@                                                                                                   @#@        @
@        @#@  &                                                                                                @@                   @                                                                               @#@        @
@        @#@@@@@@@@@@@@@@@@@@@@@@@@@@@@@@@@@@@@@@@@                                                            @@                                                            @@@@@@@@@@@@@@@@@@@@@@@@@@@@@@@@@@@@@@@@#@        @
@        @#########################################                                                            @@                                         *                  #########################################@        @
@        @@@@@@@@@@@@@@@@@@@@@@@@@@@@@@@@@@@@@@@@@@                                                            @@#                                                           @@@@@@@@@@@@@@@@@@@@@@@@@@@@@@@@@@@@@@@@@@        @
@                                                                                                              @@                                                                                                              @
@                                                                                                              @@              *                                                                                               @
@                                                                                                              @@                                                                                                              @
@                                                                                                              @@                                                                                                              @
@                         *                                                                       @            @@                           #                                                                                  @
@                                                                     *                                       #@@                                            @                     #                                           @
@                                                                                                              @@        #                                                                                                     @
@                                                                                                              @@                                                                                                              @
@                                                                                                              @@                                                                                         @                    @
@                                                                                                              @@                                                                                                              @
@                                                                                                              @@                                                              *                                               @
@                                                                                                              @@                                                                                                              @
@                                                                                                              @@                                *                                                                             @
@                  #                    @                                                                      @@#                                                      #                        #                             @
@                                                                                    #                         @@            @                                                                                                 @
@                                                                                                              @@                                                                                                              @
@                                                                                                              @@                                                                                                              @
@                                                                                                              @@                                                                  @                                           @
@                                                                                                              @@                               @                      #                                                       @
@                               *                                    @                                         @@                     *                                                                                        @
@                                                                                                              @@                                                                                   #                 @        @
@                                                                                                             #@@                                                *                                                             @
@                                            #                                                                 @@                                                                          #                                   @
@          #                                                                                                   @@                                                                                                              @
@                                                                                           *                  @@                                 #                                                                            @
@                                                                                                              @@                                                                                                              @
@                                                                                                              @@                                                                                                              @
@                        @                                                                                     @@                @                                @                                                            @
@                                                                                                              @@#                                                                                     @                       @
@                                                                                                              @@                                                                     #                                        @
@                                                                                                              @@                              *                                                                               @
@                                               *                           *                                  @@                                                                                                       #      @
@                                                                                              @               @@                                            #                                                                 @
@                                                                                                              @@                                                                                                              @
@                                                                                                             #@@                #                                                                     *                       @
@                                   #                           @                                              @@                                                                                                              @
@                                                                                                              @@                                                               @                                              @
@                                                                                                              @@                                                                                                              @
@                   #                                                                                          @@                                                                                                              @
@                                                                                                              @@                                @                                                                    *        @
@                                           *                                                                  @@                                                      *                             @                         @
@                                                                                                              @@                                                                                                              @
@                                                                                                              @@#                                                                                                             @
@                                                                                     #                        @@              @                *                                                                              @
@                 *                                                                                            @@                                            #                          #                       @              @
@                                                                                                              @@                                                                                                              @
@                                                           #                                                  @@                                                                                                              @
@                                                                                                             #@@                                                                                                              @
@                                                                                                              @@      *                    @                                                                                  @
@                                                                                                              @@                                                                 @                                            @
@                              @                                          *                                    @@                                                                                     #                        @
@                                                 *                                                            @@                                         #                                                                    @
@                                                                                                              @@                                                *                         *                                   @
@                 @                                                                  @                         @@                                                                                                              @
@                                                                                                              @@                                                                                                              @
@                                                                                                              @@#                                    *                                                                        @
@                                                                                                              @@                                                                    *                            @            @
@                                               #                    @                                         @@               @                                                                                              @
@                                                                                                              @@                                                        @                                                     @
@                               *                                                                                                                                                               @                              @
@               #                                                                                                                                                                                                              @
@                                                                                                                                           @                                                                                  @
@                                                                         #                                                                               #                                                  #          *      @
@                                                                                                             *                                                                                                                @
@                                                                                           @                                 #                                                                                                @
@                                                                                                                                                                   *                     #                                    @
@                                                                                                                                                                                                                              @
@                               #              @                                                                                                                                                                               @
@                                                                                                                                        *                                                    *                 @              @
@                                                                                #                        #                                                                                                                    @
@                                                                                                                          @                                                                                                   @
@                                                                     @                                                                                                  @                                                     @
@                    @                                                                                                                   #       @            #                                                              # @
@                                                  #                                              @                                                                                                     @                      @
@                                                                                                                                                                                       #                                      @
@                                                                                                                #                                                                                                             @
@                                                                                                                                                                                                                              @
@##############################################################################################################################################################################################################################@
@@@@@@@@@@@@@@@@@@@@@@@@@@@@@@@@@@@@@@@@@@@@@@@@@@@@@@@@@@@@@@@@@@@@@@@@@@@@@@@@@@@@@@@@@@@@@@@@@@@@@@@@@@@@@@@@@@@@@@@@@@@@@@@@@@@@@@@@@@@@@@@@@@@@@@@@@@@@@@@@@@@@@@@@@@@@@@@@@@@@@@@@@@@@@@@@@@@@@@@@@@@@@@@@@@@@@@@@@@@@@@@@