@@@@@@@@@@@@@@@@@@@@@@@@@@@@@@@@@@@@@@@@@@@@@@@@@@@@@@@@@@@@@@@@@@@@@@@@@@@@@@@@@@@@@@@@@@@@@@@@@@@@@@@@@@@@@@@@@@@@@@@@@@@@@@@@@@@@@@@@@@@@@@@@@@@@@@@@@@@@@@@@@@@@@@@@@@@@@@@@@@@@@@@@@@@@@@@@@@@@@@@@@@@@@@@@@@@@@@@@@@@@@@@@
@                                                                                                                                                                                                                              @
@                                                                                                                                                                                                                              @
@                                                                                                                                                                                                                              @
@                                                                                                                                        **                                                                                    @
@                                                                                                                                                                                                                              @
@                                                                                                                                                                                                                              @
@                                                                                                                                                                                                                              @
@                                                                                                                                                                                                                              @
@                                                                                                                                        @@                                                                                    @
@                                                                                                                                                                                                                              @
@                                                                                                                                                                                                                              @
@                                                                                                                                                                                                                              @
@                                                                    *  *                                                                                                                                                      @
@                                                                                                                                                                                                                              @
@                                                                                                                                                                                                                              @
@                                                                                                                                                                                                                              @
@                                                                                                                                                                                                                              @
@                                                                    @@@@                                                                                                                                                      @
@                                                                   @@  @@                                                       @@@@@@@@@@@@@@@@@@                                                                            @
@                                                                  @ @@@@ @                                           @@@@@@@@@@@@@@@@@@@@@@@@@@@@@@@@@@@@@@@@                                                                 @
@                                                                 @@ @  @ @@                                     @@@@@@@@@@@@@@@@@@@@@@@@@@@@@@@@@@@@@@@@@@@@@@@@@@                                                            @
@                                                                 @@@ ** @@@                                @@@@@                                                  @@@@@                                                       @
@                                                                                                        @@@@@@@@@@@@@@@@@@@@@@@@@@@@@@@@@@@@@@@@@@@@@@@@@@@@@@@@@@@@@@@@@@                                                    @
@                                                                                                     @@@                                                                  @@@                                                 @
@                                                                                                   @@@@@@@@@@@@@@@@@@@@@@@@@@@@@@@@@@@@@@@@@@@@@@@@@@@@@@@@@@@@@@@@@@@@@@@@@@@@                                               @
@                                                                                                 @@@@@@@@@@@@@@@@@@@@@@@@@@@@@@@@@@@@@@@@@@@@@@@@@@@@@@@@@@@@@@@@@@@@@@@@@@@@@@@@                                             @
@                                                                                               @@            @             @                          @             @            @@                                           @
@                      *  *                                                                    @               @@@@@@@@@@@@@                            @@@@@@@@@@@@@               @                                          @
@                                                                                             @                 @         @                              @         @                 @                                         @
@                                                                 ###@@@@###                 @                   @@@@@@@@@                                @@@@@@@@@                   @                                        @
@                                                                   ######                  @                     @     @                                  @     @                     @                                       @
@                                                                    ####                  @                       @@@@@                                    @@@@@                       @                                      @
@                      @@@@                                                                @@@@@@@@@@@@@@@@@@@@@@@@@@@@@@@@@@@@@@@@@@@@@@@@@@@@@@@@@@@@@@@@@@@@@@@@@@@@@@@@@@@@@@@@@@@@@@@@@@@@@@@                             @
@                     @@  @@                                                               ####################################### It is so easy. ##############################################@@                             @
@                    @ @@@@ @                                                              ##################   ##################@@@@@@@@@@@@@@@@##################   ##################                                      @
@                   @@ @  @ @@                                                                     #####             #####                                #####             #####                                              @
@                   @@@ ** @@@                                                                      ###               ###                                  ###               ###                                               @
@                                                                                                    #                 #                                    #                 #                                                @
@                                                                                                    #                 #                                    #                 #                                                @
@                                                                                                    #                 #                                    #                 #                                                @
@                                                                                                    #                 #                                    #                 #                                                @
@                                                                                                                                                                                                                              @
@                                                                                                                                                                                                                              @
@                   ###@@@@###                                                              *                 *                 *        **        *                 *                 *                                       @
@                     ######                                                                                                                                                                                                   @
@                      ####                                                                                                                                                                                                    @
@                                                                                                                                                                                                                              @
@                                                                                                    *                 *                                    *                 *                                                @
@                                                          *  *                            ##                 #                 ##                ##                 #                 ##                                      @
@                                                                                          ##                 #                 ##                ##                 #                 ##                                      @
@                                                                                          ##                 #                 ##                ##                 #                 ##                                      @
@                                                                                          ###               ###               ###                ###               ###               ###                                      @
@                                                                                          ######         #########         ######                ######         #########         ######                                      @
@                                                          @@@@                            #########   ###############   #########                #########   ###############   #########                                      @
@                                                         @@  @@                  @@       ##############################################@@#####################################################@@                             @
@                                                        @ @@@@ @                          @@@@@@@@@@@@@@@@@@@@@@@@@@@@@@@@@@@@@@@@@@@@@@@@@@@@@@@@@@@@@@@@@@@@@@@@@@@@@@@@@@@@@@@@@@@@@@@@@@@@@@@                             @
@                                                       @@ @  @ @@                         @                       @@@@@                                    @@@@@                       @                                      @
@                                                       @@@ ** @@@                          @                     @     @                                  @     @                     @                                       @
@                                                                                            @                   @@@@@@@@@                                @@@@@@@@@                   @                                        @
@                                                                                             @                 @         @                              @         @                 @                                         @
@                                                                                              @               @@@@@@@@@@@@@                            @@@@@@@@@@@@@               @                                          @
@                                                                                               @@            @             @                          @             @            @@                                           @
@                                                                                               ##@@@@@@@@@@@@@@@@@@@@@@@@@@@@@@@@@@@@@@@@@@@@@@@@@@@@@@@@@@@@@@@@@@@@@@@@@@@@@@@@##                                           @
@                                                                                                 ##@@@@@@@@@@@@@@@@@@@@@@@@@@@@@@@@@@@@@@@@@@@@@@@@@@@@@@@@@@@@@@@@@@@@@@@@@@@@##                                             @
@                                                                                                   ##@@@                                                                  @@@##                                               @
@                                                       ###@@@@###                                    ###@@@@@@@@@@@@@@@@@@@@@@@@@@@@@@@@@@@@@@@@@@@@@@@@@@@@@@@@@@@@@@@@@@###                                                 @
@                                                         ######                                         ###@@@@@                                                  @@@@@###                                                    @
@                                     *  *                 ####                                             #####@@@@@@@@@@@@@@@@@@@@@@@@@@@@@@@@@@@@@@@@@@@@@@@@@@#####                                                       @
@                                                                                                                #####@@@@@@@@@@@@@@@@@@@@@@@@@@@@@@@@@@@@@@@@#####                                                            @
@                                                                                                                     ###########@@@@@@@@@@@@@@@@@@###########                                                                 @
@                                                                                                                                ##################                                                                            @
@                                                                                                                                                                                                                              @
@                                     @@@@                                                               *                                                                         *                                           @
@                                    @@  @@                                                                                                                                                                                    @
@                                   @ @@@@ @                                                                                    *                          *                                                                   @
@                                  @@ @  @ @@                                                 @@                                                                                                   @@                          @
@                                  @@@ ** @@@                                                 ##                                                                                                   ##                          @
@                                                                                                                                                                                                                              @
@                                                                                                                                                                                                                              @
@                                                                                                                @@                           @@                       @@                                                      @
@                                                                                                                ##                           ##                       ##                                                      @
@                                                                                                                                                                                                                              @
@                                                                                                                                                                                                                              @
@                                                                                                                                                                                                                              @
@                                  ###@@@@###                                                                                                                                                                                  @
@                                    #######                                                                                                                                                                                   @
@                                     ####                                                                                                                                                                                     @
@                                                                                                                                                                                                                              @
@                                                                                                                                                                                                                              @
@                                                                                                                                                                                                                              @
@                                                                                                                                                                                                                              @
@                                                                                                                                                                                                                              @
@                                                                                                                                                                                                                              @
@                                                                                                                                                                                                                              @
@                                                                                                                                                                                                                              @
@                &                                                                                                                                                                                                             @
@               @@@@@@@@@@@@@@@@@@@                                                                                                                                                                                            @
@############                         #########################################################################################################################################################################################@
@@@@@@@@@@@@@@@@@@@@@@@@@@@@@@@@@@@@@@@@@@@@@@@@@@@@@@@@@@@@@@@@@@@@@@@@@@@@@@@@@@@@@@@@@@@@@@@@@@@@@@@@@@@@@@@@@@@@@@@@@@@@@@@@@@@@@@@@@@@@@@@@@@@@@@@@@@@@@@@@@@@@@@@@@@@@@@@@@@@@@@@@@@@@@@@@@@@@@@@@@@@@@@@@@@@@@@@@@@@@@@@@